10
S S S S S S S S S S
S P 0 S 0 B B B 0 S
S B 0 0 0 0 0 0 0 S
S 0 0 S 0 0 0 0 0 S
S 0 T S 0 0 W T T S
S 0 0 0 S W W T 0 S
S 0 0 0 0 0 T 0 0 S
S 0 T 0 0 0 0 0 0 S
S 0 T 0 0 0 0 0 0 S
S S S S S S S S S S
